************************************
************************************
************************************
*                     ***   ********
****** **** ********* ***** ********
*   ******* *****     *****    F****
* * ****        *********** ********
* * **** ****** * ********* ********
S *      ****** * *   ***   ********
******** *      * *** *****    *****
**** *** * ****** *** **    ********
**** *** *        *** *** **********
**** *** ******* **** *** **********
**             *             *******
************************************